19x24
08x12
1 1 1 1 1 1 1 1 1 1 1 1 1 1 1 1 1 1 1
1 0 0 0 0 0 0 0 0 0 0 0 0 0 0 0 0 2 1
1 0 2 0 0 0 0 0 0 0 0 0 0 0 0 0 0 2 1
1 0 2 0 0 0 0 0 0 0 0 0 0 0 0 0 0 3 1
1 0 2 0 0 0 0 0 0 0 0 0 0 0 0 0 0 3 1
1 0 0 0 0 0 0 0 0 0 0 0 0 0 0 0 0 4 1
1 0 0 0 0 0 0 0 0 0 0 0 0 0 0 0 0 4 1
1 0 0 0 0 0 0 0 0 0 0 0 0 0 0 0 0 5 1
1 0 0 0 0 0 0 0 0 0 0 0 0 0 0 0 0 5 1
1 0 0 0 0 0 0 0 0 0 0 0 0 0 0 0 0 6 1
1 0 0 0 0 0 0 0 0 0 0 0 0 0 0 0 0 6 1
1 0 0 0 0 0 0 0 0 0 0 0 0 0 0 0 0 7 1
1 0 0 0 0 0 0 0 0 0 0 0 0 0 0 0 0 7 1
1 0 0 0 0 0 0 0 0 0 0 0 0 0 0 0 0 8 1
1 0 0 0 0 0 0 0 0 0 0 0 0 0 0 0 0 8 1
1 0 0 0 0 0 0 0 0 0 0 0 0 0 0 0 0 9 1
1 0 0 0 0 0 0 0 0 0 0 0 0 0 0 0 0 9 1
1 0 0 0 0 0 0 0 0 0 0 0 0 0 0 0 0 0 1
1 0 0 0 0 0 0 0 0 0 0 0 0 0 0 0 0 0 1
1 0 0 0 0 0 0 0 0 0 0 0 0 0 0 0 0 0 1
1 0 0 0 0 0 0 0 0 0 0 0 0 0 0 0 0 0 1
1 0 0 0 0 0 0 0 0 0 0 0 0 0 0 0 0 0 1
1 1 2 2 3 3 4 4 5 5 6 6 7 7 8 8 9 9 1
1 1 1 1 1 1 1 1 1 1 1 1 1 1 1 1 1 1 1
